module.exports = {
  name: "Turkish",

  global: {
    home: "Ana Sayfa",
    subscriptions: "Abonelikler",
    library: "Kitaplık",
    restart: "Yeniden Başlat",
    later: "Daha Sonra",
    settingRestart: "Bu ayarın değiştirilmesi, değişikliklerin uygulanabilmesi için uygulamanın yeniden başlatılmasını gerektirir."
  },

  index: {
    connecting: "Bağlanılıyor",
    plugins: "Eklentiler Yükleniyor",
    launching: "Başlatılıyor",
  },

  settings: {
    general: "Genel",
    theme: "Tema",
    player: "Oynatıcı",
    uitweaker: "UI Düzenleyici",
    startupoptions: "Başlangıç Ayarları",
    plugins: "Eklentiler",
    updates: "Güncellemeler",
    logs: "Günlükler",
    about: "Hakkında",
    devmode: "Kayıt Defteri Düzenleyici",
  },

  mods: {
    general: {
      language: "Dil",
    },
    theme: {
      normal: "Normal",
      adaptive: "Uyarlanabilir",
      custom: "Özel",
      dark: "Karanlık",
      black: "Siyah",
      darkmode: "Karanlık Mod",
      darkmodetagline: "Bravo Altı, Karanlığa Geçiyoruz.",
    },
    tweaks: {
      fullscreen: "Tam Ekran",
      navbarblur: "Gezinti Çubuğu Bulanıklığı",
      roundedcorners: "Yuvarlatılmış Köşeler",
      roundthumbnails: "Yuvarlak Küçük Resim",
      roundwatchpagecomponents: "Yuvarlak İzleme Sayfası Bileşenleri",
      radius: "Yarıçap",
    },
    startup: {
      defaultpage: "Varsayılan Sayfa",
    },
    updates: {
      install: "Yükle",
      view: "Göster",
      latest: "En son",
      installed: "Yüklendi",
    },
    logs: {
      more: "Daha Fazla",
    },
    about: {
      appinformation: "Uygulama Bilgileri",
      appversion: "Uygulama Sürümü",
      deviceinformation: "Cihaz Bilgileri",
      platform: "Platform",
      os: "İşletim Sistemi",
      model: "Model",
      manufacturer: "Üretici",
      emulator: "Emülatör",
      github: "GitHub",
      discord: "Discord",
    },
  },

  events: {
    welcome: "VueTube'a Hoş Geldin",
    tagline: "Video akışının geleceği",
    next: "İleri",
    updated: "VueTube Güncellendi!",
    awesome: "Harika!",
    langsetup: "Haydi Bir Dil Seç!",
    featuresetup: "Haydi Birkaç Özellik Seç!",
    enableryd: "Return YouTube Dislike'ı Etkinleştir",
    enablespb: "SponsorBlock'u Etkinleştir",
    thanks: "VueTube'u Kullandığın için Teşekkürler",
    enjoy: "Umarız harika bir deneyim yaşarsınız",
  },
};
